2
180
1
222222222222222222222222
2        t t t         2
2  X                   2
2    L   c     c   tttt2
2111111111111111111SSSS2
2                      2
2  a a a a a a a a a   2
2                      2
2SSSS1111111111111111112
2SSSS    b             2
2                      2
2                  tttl2
2111111111111111111SSSS2
2  c                   2
2     c                2
2       c        tttl  2
211111111111SSSSSSSSSSS2
2     S    1           2
2  a  S lt 1  a a a    2
2     S    1           2
2SSSS111SS11   a a a   2
2    1     1           2
2    1  a  1           2
2    1     1   ttLtt   2
2    1111SS1111SSSSS1112
2    1     1           2
2    1  a  1  c     c  2
2    1     1           2
2    1SS111111111111SSS2
2    1                 2
2    1   d       d     2
2    1                 2
2    1111111111111SSSS12
2    1                 2
2    1                 2
2    1  z   tttt   L   2
2    1111111111111111112
2                      2
2      c               2
2          c     c     2
2SSSS1111111111111111112
2                      2
2   a  a  a  a  a  a   2
2                tttttl2
21111111111111111SSSSSS2
2                      2
2                      2
2    c                 2
2   1111               2
2                      2
2         c            2
2       11111          2
2               c      2
2             11111    2
2                      2
2 Z                  L 2
222222222222222222222222
