3
180
2
2222222222222222222222222222222222222222222222222222222222222222222222222222222222222222222222222222222222
2                            2                    2                                                      2
2                            2                    2 L                                                    2
2                            2                    22222                                                  2
2                            2          a a a a   2                          c        c                  2
2                            2           a a a    2                                                      2
2                            2                    2  z                                                   2
2              a a a         2                    211111                 a  a        a  a                2
2           a a a a a a      2                    2                        a           a                 2
2                            2tttLtttt    c   c   2                      a  a        a  a                2
2                            2SSS22222            2                                                      2
2  X                          SS                  2                                                      2
2        ttt              tt lSS                tt2                                                      2
2        111         c  SS111111                112                                                      2
2                 111111SS     1      tttt        2                                                      2
2              c  1      1  l  1                  2      b              b      l       l    b            2
2            111111      111   1                  2                                                      2
2            1     L     SSS   S                                                                         2
2     c   1111   tttttt  SSS   S   c       c     c              c                  c               Z     2
2222222222222222222222222222222222222222222222222222222222222222222222222222222222222222222222222222222222
